20 20
. # . . % . # # . . . . . # . . . . # .
. . . . . . . . # . # . . # % . # % . .
. . . . . . . . . # # . . # # % @ . % #
. . . . # . . . . # . . . % . . . . . #
% . . . . . . . . # . % . . # # # . % .
. . % # . . # . . . . . . . . % # . # .
. . . . . # . . . . . . . . . . # . # #
# # . . . % % # . # . . . . . # . . . .
$ % . # # . . . . . . . . . . . # % # .
. . . % # # . # # # # . # . # . . # . .
% . . . . % % . # . . # . % % . . . . .
. # . . # . # # . . # . % # % # . . # .
# % . # # . . # . . . . . . # . . . . .
% . . . . # . . . % # . . % . . . . . %
. # . % . . . . . . # . # # . . % . . %
. % # . . . . % . . . . # . % . % . # %
% # . % . . # . . . # . . . . . . . . .
. . . . . # . . . . . # . . . . . . % .
. . . . . % . % . . . . . % . . . . # #
# . # . . . # . . . . . . % . . # # # #