10 10
. # . . % . # # @ .
. . . # . . . . # .
. . . . . . . . # .
# . . # % . # % . .
. . . . . . . . . #
# . . # # % . . % #
. . . $ # . . . . #
. . . % . . . . . #
% . . . . . . . . #
. % . . # # # . % .