15 15
. . . . . . . . . # . . . . #
. . . . % . . # # . # # . # %
. . # . # # . # . . . # . . .
. . . . . . . . . . . . # . #
# . % . . . # . # . . . . % %
. % . . . . . . . . . # % . @
# . . . # # . # . . . . . . %
. . . . . . . . # % . . . # .
. . . . . # . . . . . . . . .
# . # . . . . . . . . # . # .
. . % . . # . . # % . . . . .
. . # . % . . . . . % . # . #
% . . # # . % . . . . # . . .
. . . . % . # # . . . # . # #
. . . . . . . $ % . . . % . .