5 5
@ # $ . %
. # % . #
. . # . .
% . . . %
# # # % #